"filename", "language", "JavaScript", "comment", "blank", "total"
"d:\Documenti\Università\Polito\Software Engineering\Group Project 2\EzWh\code\server\routers\InternalOrderRouter.js", "JavaScript", 144, 9, 38, 191
"d:\Documenti\Università\Polito\Software Engineering\Group Project 2\EzWh\code\server\routers\ItemRouter.js", "JavaScript", 122, 7, 32, 161
"d:\Documenti\Università\Polito\Software Engineering\Group Project 2\EzWh\code\server\routers\PositionRouter.js", "JavaScript", 124, 9, 31, 164
"d:\Documenti\Università\Polito\Software Engineering\Group Project 2\EzWh\code\server\routers\RestockOrderRouter.js", "JavaScript", 187, 10, 46, 243
"d:\Documenti\Università\Polito\Software Engineering\Group Project 2\EzWh\code\server\routers\ReturnOrderRouter.js", "JavaScript", 95, 13, 22, 130
"d:\Documenti\Università\Polito\Software Engineering\Group Project 2\EzWh\code\server\routers\SKUItemRouter.js", "JavaScript", 134, 16, 22, 172
"d:\Documenti\Università\Polito\Software Engineering\Group Project 2\EzWh\code\server\routers\SKURouter.js", "JavaScript", 162, 14, 31, 207
"d:\Documenti\Università\Polito\Software Engineering\Group Project 2\EzWh\code\server\routers\TestDescriptorRouter.js", "JavaScript", 128, 14, 25, 167
"d:\Documenti\Università\Polito\Software Engineering\Group Project 2\EzWh\code\server\routers\TestResultRouter.js", "JavaScript", 130, 15, 22, 167
"d:\Documenti\Università\Polito\Software Engineering\Group Project 2\EzWh\code\server\routers\UserRouter.js", "JavaScript", 251, 24, 45, 320
"Total", "-", 1477, 131, 314, 1922